			      NO ./files/texture/north_texture
SO   ./files/texture/south_texture
WE      ./files/texture/west_texture
EA         ./files/texture/east_texture

F 55,25,255
C 225,30,0



	





1111        11111111
1001        100011101
1011        1000111011
10001111111111011111
11101111011111111
100010000000001111
1010000000000011101
10101011111111111111111
1010111111111111
101011     1000111
101011  1   1000011
101011  1   1000111
100001     1000011
100001111111000011
10000N1 101000011
1111111 111111111