NO ./files/texture/east_texture
SO ./files/texture/east_texture
EA ./files/texture/east_texture
WE ./files/texture/east_texture
C 255,22,55
F 25,22,55



11111111111111111111111111111
10000000000000000000000000001
10000000000000000000000000001
10000100000000000000000000001
10000000000000000001000000001
100000000N0000000000000000001
10000000000000000000000000001
100000010000000000000000000001
10000000000000000000000000001
10000000001000000000000000001
10000000000000000000000000001
10000000000000000000000000001
10000000000000000000110000001
11111111111111111111111111111























