WE      ./files/texture/west_texture
              EA         ./files/texture/east_texture.xpm
     SO ./files/texture/south_texture
   NO ./files/texture/north_texture

F 55,25,55
C 225,30,255

1111111111111111
10000N1
1111111111111111