         NO ./files/texture/north_texture
SO ./files/texture/south_texture
WE      ./files/texture/west_texture
EA         ./files/texture/east_texture
F 55,25,55
C 225,30,77


            




11111111111111111111111
10110100001000000000001
10110100001000000000001
1011010000100000000001
10110100001N0000000001
1011010000100000000001
11000010001000010010001
10010100000000000000011
11111111111111111111111



