SO ./files/texture/south_texture
        NO ./files/texture/north_texture
WE      ./files/texture/west_texture
C 225,30,77
F 55,25,55
EA         ./files/texture/east_texture


            







                
















11111111111111111111111
101101000000000000000011111111111111111111
10110100000000000000001
1011010000101000000001
10110100000N0000000001
1011010000101000000001
11000010000000010010001
10010100000000000000011
11111111111111111111111



