     WE      ./files/texture/west_texture
              EA         ./files/texture/east_texture
     SO ./files/texture/south_texture
   NO ./files/texture/north_texture

F 55,25,55
C 225,30,255

1
111111111111111111111111111111111111111111
1100000000001                  11000000001
101000000010111111111111111111110100000001
100010000010000000000000000000000001000001
100100000011111111111111111111110010000001
10001000001                    10001000001
10000100001          1         10000100001
10000010001                    10000010001
10000001001      111111111   1100000100111
100W0000101        11          10000000101
1000000011                    10000000011 
111111111111111111111111111111111111111111

