	            

			      NO ./files/texture/north_texture
SO   ./files/texture/south_texture
WE      ./files/texture/west_texture
EA         ./files/texture/east_texture


F 220,25,100




C 225,30,0





11111111111111111111
10000000010000000001
10000000010000000001
10000000010000000001
10000000010000000001
10000000010000000001
10000000010000000001
10000000010000000001
10000000010000000001
10000000010000000001
11111111111111111111
10000000010000000001
10000000010000000001
10000000010000000001
10000000010000000001
10000000010000000001
10000000010000000001
10000000010000000001
10000000010000000001
100000000W0000000001
11111111111111111111