         NO ./files/texture/north_texture
SO ./files/texture/south_texture
WE      ./files/texture/west_texture
EA         ./files/texture/east_texture
F 55,25,55
C 225,30,77


            



1111        11111111
1001        100011101
1011        10001111
1000111111111000000111
1000000000000000001
1000000000000000001
10000000000000000001
100000000000000000111
1000000000000000001
1000000000000000001
1000000000000000001
10000000000000000011
10000000000000000011
1000000000000000001
1000000100000000001
10000N1 1010000111
1111111 111111111









