	            

			      NO ./files/texture/north_texture
SO   ./files/texture/south_texture
WE      ./files/texture/west_texture
EA         ./files/texture/east_texture


F 220,25,100




C 225,30,0





11111111111111111111
10000000010000000001
10000000010000000001
10000000011111110001
10000000010000000001
10000000010011110001
10000000010011110001
10000000010011110001
10000000010011110001
10000000010011110001
11111111111111111111
10001000010000000001
10001000010000000001
10001000010000000001
10001000010000000001
10001000010000000001
10001000010011100001
10000000010011100001
10000000010011100001
100000000W0011100001
11111111111111111111
