         NO ./files/texture/north_texture
SO ./files/texture/south_texture
WE      ./files/texture/west_texture
EA         ./files/texture/east_texture
F 55,25,55
C 225,30,77


            




1111111111111111111
1010001000000000001
1010001000000000001
1111111111111100011
101000010101  111111
10100010N01   111111
101000010101 111111
1100001001111111111
1000000000000000011
1111111111111111111



