WE      ./files/texture/west_texture.xpm
EA         ./files/texture/east_texture.xpm
SO ./files/texture/south_texture.xpm
NO ./files/texture/north_texture.xpm
F 255,165,79
C 135,206,235






11111111111111111111111111111
10001000000000000000000000001
10S0D000000000000000000000001
11D11000000000000000000000001
10000000000000000000000000001
10000000000000000000000000001
10000000000000000000000000001
10000000000000000000000000001
10000000000000000000000000001
11111111111111111111111111111