	            

			      NO ./files/texture/north_texture
SO   ./files/texture/south_texture
WE      ./files/texture/west_texture
EA         ./files/texture/east_texture


F 220,25,100




C 225,30,0

















1111111111111111111111111111111111
11111111111111111100110000000000001111111111111111
10110000011111000111111111111111001
100100000001110000000011111111111111111
11111111101101110000000000001
100000000010111100111111111111111
1111011111111110100000010001
1111111111111010101010010001
11000000110101010100000010001
1000011100000101000000100011
10000111000W0010101010010001
11000001110101010111111000111
1111011111101011101 1110001
1111111111111111111 111111





