WE      ./files/texture/west_texture.xpm
EA         ./files/texture/east_texture.xpm
SO ./files/texture/south_texture.xpm
NO ./files/texture/north_texture.xpm
F 255,165,79
C 135,206,235






1111111111111111
1000100000000001
10S0D00000000001
11D1100000000001
1000000000000001
1000000000000001
1000000000000001
1111111111111111