WE      ./files/texture/west_texture
              EA         ./files/texture/east_texture.xpm
     SO ./files/texture/south_texture
   NO ./files/texture/north_texture

F 255,165,79
C 135,206,235

1111111111111111
1000000000000001
1000000000000001
1000000000000001
1000000000000001
100000000N000001
1000000000000001
1111111111111111