         NO ./files/texture/north_texture
SO ./files/texture/south_texture
WE      ./files/texture/west_texture
EA         ./files/texture/east_texture
F 55,25,55
C 225,30,77


            




11111111111
10110000001
1100N010001
10000000001
11111111111



