	            

			      NO ./files/texture/north_texture
SO   ./files/texture/south_texture
WE      ./files/texture/west_texture
EA         ./files/texture/east_texture


F 220,25,100




C 225,30,0





11111111111111111
10000100000000011
101010000000001  1
101011111110001  1
111111111111111  1
101010000000001  1
101010000000001  1
101010111111111  1
101010000000001  1
101010000000001  1
101010011000001  1
10000100101000011
10000100101000011
10000N00001000011
11111111111111111
