
			      NO ./files/texture/north_texture
SO   ./files/texture/south_texture
WE      ./files/texture/west_texture
EA         ./files/texture/east_texture

F 55,25,255
C 225,30,0

111111111
101000101
1100N0001
111111111