WE      ./files/texture/west_texture.xpm
EA         ./files/texture/east_texture.xpm
SO ./files/texture/south_texture.xpm
NO ./files/texture/north_texture.xpm
F 255,165,79
C 135,206,235






       1111111111111111
       1000100000000001
1111111100000000000001
1101100000000011111111
1001D1000000001
10000000000S00011111111
11111111000000000000001
       1111111111111111