		         

				 NO ./path_to_the_north_texture
SO   ./path_to_the_south_texture
WE      ./path_to_the_west_texture
EA         ./path_to_the_east_texture


F 220,25,100




C 225,30,0

















1111111111111111111111111111111111
11111111111111111100110000000000001111111111111111
1011000001111100011111111111111111
100100000001110000000011111111111111111
11111111101101110000000000001
100000000010111100111111111111111
1111011111111110100000010001
11110111111111010101010010001
11000000110101010100000010001
10000000000000010100000010001
100000000000W0010101010010001
11000001110101010111111000111
1111011111101011101111110001
111111111111111111111111111





