		         

				 NO ./path_to_the_north_texture
SO ./path_to_the_south_texture
WE ./path_to_the_west_texture
EA ./path_to_the_east_texture


F 220,25,100
C 225,30,0
















1
	   1111111111111111111111111
111111111111	10011000000001111111111111111
101100000111	100011111111111111111
100100000001	10000000011111111111111111
111111111011	101110000000000001
100000000010111100111111111111
11110111111111011000000010001
11110111111111011001010010001
11000000110101011000000010001
10000000000000001000000010001
10000000000000001001010010001
11000001110101011011011110N0111
11110111 11101011001111010001
11111111 1111111 111111111111